0,0,0,0,0,0,0,0,0,0,0,0,0,0,0,0,0,0,0,0,0,0,0,0,0,0,0,0,0,0,0,0,0,0,0,0,0,0,0,0
0,5,2,4,1,1,2,1,1,1,1,1,1,1,1,1,1,1,4,0,0,1,1,1,1,1,1,1,1,1,1,1,1,1,1,1,1,1,1,0
0,6,3,5,1,1,2,1,2,3,1,1,1,1,1,1,1,1,4,1,1,1,1,1,1,1,1,1,1,1,1,1,1,1,1,1,1,1,1,0
0,4,3,3,1,1,2,1,2,3,1,1,1,1,1,1,1,1,4,1,1,1,1,1,1,1,1,1,1,1,1,1,1,1,1,1,1,1,1,0
0,7,2,2,0,0,1,1,1,0,0,0,1,1,1,0,0,1,4,1,1,1,1,0,0,1,1,1,0,0,0,1,1,1,0,0,3,2,3,0
0,1,1,1,1,1,1,1,1,1,1,1,1,1,1,1,1,1,4,1,1,1,1,1,1,1,1,1,1,1,1,1,1,1,1,1,2,1,3,0
0,1,1,1,1,1,5,4,3,1,1,1,1,1,1,1,1,1,4,1,1,1,1,1,1,1,1,1,1,1,1,1,1,1,1,1,2,4,3,0
0,1,1,1,1,1,5,4,3,1,1,1,1,1,1,1,1,1,4,0,0,1,1,1,1,1,1,1,1,1,1,1,1,1,1,1,1,1,1,0
0,1,1,1,0,0,5,4,3,0,0,0,6,6,6,0,0,0,0,0,0,0,0,0,0,1,1,1,0,0,0,5,1,1,0,0,1,1,1,0
0,1,1,1,1,1,5,4,3,1,0,1,1,1,1,1,1,1,1,1,1,1,1,1,1,1,1,1,1,0,1,5,1,1,1,1,1,1,1,0
1,1,1,1,1,1,2,2,3,1,0,1,1,1,1,1,1,1,1,1,1,1,1,1,1,1,1,1,1,0,1,5,1,1,1,1,1,1,1,1
1,1,1,1,1,1,2,2,3,1,0,1,1,1,1,1,1,1,1,1,1,1,1,1,1,1,1,1,1,0,1,5,1,1,1,1,1,1,1,1
1,1,1,1,0,1,2,2,3,1,0,0,0,0,0,0,0,0,1,1,1,1,0,0,0,0,0,0,0,0,1,5,1,1,1,0,1,1,1,1
0,1,1,1,0,1,2,2,3,1,1,1,1,1,1,1,3,1,1,1,1,1,2,1,1,1,1,1,1,1,1,1,1,1,1,0,1,1,1,0
0,1,1,1,0,1,1,1,1,1,1,1,1,1,1,1,3,1,1,1,1,1,2,1,1,1,1,1,1,1,1,1,1,1,1,0,1,1,1,0
0,1,1,1,0,1,1,1,1,1,1,1,1,1,1,1,3,2,1,1,2,2,1,1,1,1,1,1,1,1,1,1,1,1,1,0,1,1,1,0
0,1,1,1,0,0,0,0,0,0,0,0,0,0,0,0,3,2,1,0,0,2,1,1,0,0,0,0,0,0,0,0,0,0,0,0,1,1,1,0
0,3,3,3,0,1,1,1,1,1,1,1,0,1,2,1,1,1,1,0,0,1,1,1,1,1,1,0,1,3,1,1,1,1,1,0,1,1,1,0
0,1,1,1,0,1,1,1,1,1,1,1,0,1,2,1,1,1,1,0,0,1,1,1,1,1,1,0,1,3,1,1,1,1,1,0,1,1,1,0
0,1,1,1,0,1,1,1,1,1,1,1,0,1,2,1,1,1,1,0,0,1,1,1,1,1,1,0,1,3,1,1,1,1,1,0,1,1,1,0
0,1,1,1,1,1,1,1,0,1,1,1,1,1,2,1,1,1,1,0,0,1,1,1,1,1,1,1,1,3,1,0,1,1,1,1,1,1,1,0
0,1,1,1,1,1,1,1,0,1,1,1,1,1,2,1,1,1,1,0,0,1,1,1,1,1,1,1,1,3,1,0,1,1,1,1,1,1,1,0
0,1,1,1,1,1,1,1,0,1,1,1,1,1,2,0,1,1,1,0,0,1,1,1,0,1,1,1,1,3,1,0,1,1,1,1,1,1,1,0
0,0,0,0,0,0,0,0,0,0,0,0,0,0,0,0,0,0,0,0,0,0,0,0,0,0,0,0,0,0,0,0,0,0,0,0,0,0,0,0
